XXXXXXXXXXXXXXXXXXXXXXXXXXXXXXXXXAXXXXXXXXXXXXXXXXXXXXXXXXX...........
XXXXXXXXXXXXXXXXXXXXXXXXXXXXXXXXXXAAXXXXXXXXXXXXXXXXXXXXX.............
XXXXXXXXXXXXXXXXXXXXXXXXXXXXXXXAXXXXX####XXXXXXXXXXXX.X...............
XXXXXXXXXXXXXXXXXXXXXXXXXXXXXXXXAXA########XAXXXXXXXX.................
XXXXXXXXXXXAXXXXXXXXXXXXXXXXXXXAAX###########XXXAX.X..................
XXXXXXXXXXAXXXXXXXXXXXXXXXXXAXXX##################....................
XXXXXXXXXXXXAXXAXXXXXXXXXXAAXXX#################.#....................
XXXXXXXXXAXAXAAXXXXXXXXXXXXXXA#####################...................
XXXXXXXXAXXA##XXAXXXXXXXXXXAXA######################..................
XXXXXXXXXXXA###XAXXXXXXXXAXXAX######################..................
XXXXXXXXXAXX###XXXXXXXXXXAXXXX######################..................
XXXXXXXXXAXX###XXXXXXXXXXXXAAXX####################X..................
XXXXXXXXXAXXXAXXXXXXXXXXXXXXAXAAAXAXAXXAAXXAAAAXXXX...................
XXXXXXXXXXXXXXXXXXXXXXXXXXXXXXXXXXXXXXXXXXXXXXXXXXXX..................
XXXXXXXXXXXXXXXXXXXXXXXXXXXXXXXXXXXXXXXXXXXXXXXXXXXXXX................
XXXXXXXXXXXXXXXXXXXXXXXXXXXXXXXXXXXXXXXXXXXXXXXXXXXXXXX...............
XXXXXXXXXXXXXXXXXXXXXXXXXXXXXXXXXXXXXXXXXXXXXXXXXXXXXXXX..............
XXXXXXXXXXXXXXXXXXXXXXXXXXXXXXXXXXXXXXXXXXXXXXXXXXXXXX.X..............
XXXXXXXXXXXXXXXXXXXXXXXXXXXXXXXXXXXXXXXXXXXXXXXXXXXXXXXXX.............
XXXXXXXXXXXXXXXXXXXXXXXXXXXXXXXXXXXXXXXXXXXXXXXXXXXXXAXAA.............
XXXXXXXXXXXXXXXXXXXXXXXXXXXXXXXXXXXXXXXXXXXXXXXXXXXXXAXXX.............
XXXXXXXXXXXXXXXXXXXXXXXXXXXXXXXXXXXXXXXXXXXXXXXXXXXXXXXX..............
XXXXXXXXXXXXXXXXXXXXXXXXXXXXXXXXXXXXXXXXXXXXXXXXXXXXXXXXA.............
XXXXXXXXXXXXXXXXXXXXXXXXXXXXXXXXXXXXXXXXXXXXXXXXXXXXXXXA.X............
XXXXXXXXXXXXXXXXXXXXXXXXXXXXXXXXXXXXXAXXXAXXXXXXXXXXXXXXXAX...........
XXXXXXXXXXXXXXXXXXXXXXXXXXXXXXXXXXXXXXXAXXXXXXXXXXXXXXXXXX............
XXXXXXXXXXXXXXXXXXXXXXXXXXXXXXXXXXXXAXXXAAXXXXXXXXXXXXXAXX.A..........
XXXXXXXXAXXAXXXXXXXXXXXXXXXXXXXXXXXXXXAXXXXXXXXXXXXXXXXXXXXX..........
XXXXXXXXXXXXXXXXXXXXXXXXXXXXXXXXXXXXAXXXX####XXXXXXXXXXXXXX...........
XXXXXXAXXXXAXXXXXXXXXXXXXXXXXXXXXXAXXAA######XXXXXXXXXXXXXXX..........
XXXXXAXXXXXXAXXXXXXXXXXXXXXXXXXAXXAAXAX######XXXXXXXXXXXXXXX..........
XXXXXAXXAAXXXXXXXXXXXXXXXXXXXXXXAXXXXX#######XXXXXXXXXXXXXXX..........
XAXXXAXXXXXXXXXXXXXXXXXXXXXXXXXAXXXAA#######XXXXXXXXXXXXXXXX..........
AAAXXXAXAAXXXXXXXXXXXXXXXXXXXXXXXXXAX######XXXXXXXXXXXXXXXXX..........
AXAAXXXXAXXXXXXXXXXXXXXXXXXXAXXXXXXA#######XXXXXXXXXXXXXXX.XX.........
XXXXAXXAXXXXXXXXXXXXXXXXXXXAAXXXXAAA#######XXXXXXXXXXXXXXXXX..........
AAXXAXAXAXXXXXXXXXXXXXXXXXXXAXXAAXX#######XXXXXXXXXXXXXXXXXX..........
XXXXXXAXAXXXXXXXXXXXXXXXXXXXXXAAAXX#######XXXXXXXXXXXXXXXXX...........
XXXXXXAXXXXXXXXXXXXXXXXXXXXAAAAXXXX######XXXXXXXXXXXXXXXXXX...........
XXAXXXXAXXXXXXXXXXXXXXXXXXXXAXXXXXXXXX#XXXXXXXXXXXXXXXXXAA............
XXXXAAXXXXXXXXXXXXXXXXXXAXXXXXXXXXXXXXXXXXXXXXXXXXXXXXAX..............
XXXXX....XXXXXXXXXXXXXXXXXXXXXXXXXXXXXXXXXXXXXXXXXXXXX................
XXX.....XX.XXXXXXXXXXXAXAXXXXXXXXXXXXXXXXXXXXXXXXXX.................XX
X........XXXXXXXXXXXXXAXXXAXXXXXXXXXXXXXXXXXXX.......................X
..............XXXXXXXXXXXXXXXXXXXXXXXXXXXX............................
XXX.XX...XXXXXXXXXXXAXXAXXXXXXXXXXXXXXXXXXXXXXXXXXXXX.X...............
X..XXX..XXXAXXXXXXAXXXXXAXXXXXXXXXXXXXXXXXXXXXXXXXXX.XX...............
X.........XAXXXXXXAXXAXXXAAXXXXXXXXXXXXXXAXXX........................X
..............XAXXAAAAXXAAXXXXXXXXXXXXXAXAXXX.......................X.
......................................................................

