......................................................................
......................................................................
.........AXXXXX.XXXXXXXXXA######XXXAAXAAXXXXXX.XXXX...................
....X.XXXXXAXXXXXXXXXXXXX########XXXAAAXAXXXXXXXXXX...................
...XXXXXAAXXXXXXXXXXXXXX##############XXXAXXXXXXXXX...................
...XXXXXXAXAXXXXXXXXXXA################XXXXXXXXXXXXX..................
...XXXXXA##XXXXXXXXXXX#################XXXXXXXXXXXXXXXXX..............
...XXXXXX##XAXXXXXXXXX#################AXXXXXXXXXXXXXXXX..............
...XXXXXX##XXXXXXXXXXXA###############XAAXXXXXXXXXXXXXX...............
...XXXXAAAXXXXXXXXXXXXXXXXXAXXXAXAXAXXXAXAXXXXXXXXXXXXXXXX............
..XXXXXXXAXAXXXXXXXXXXXXAXXXXXXXXAXXXAXXXXXXXXXXXXXXXXXXXX............
...XXXXXAXAXXXXXXXXXXXXXXXXXXXXXXXXXXXXXXXXXXXXXXXXXXXXXX.............
..XXXXXXXXXXXXXXXXXXXXXXXXXXXXXXXXXXXXXXXXXXXXXXXXXXXXXXXXX...........
..XXXXXXXXXXXXXXXXXXXXXXXXXXXXXXXXXXXXXXXXXXXXXXXXXXXXXXXXXX..........
..XXXXXXXXXXXXXXXXXXXXXXXXXXXXXXXXXXXXXXXXXXXXXXXXXXXXXXXXXX..........
..XXXXXXXXXXXXXXXXXXXXXXXXXXXXXXXXXXXXXXXXXXXXAAXAAXXXXXXXXXX.........
..XXXXXXXXXXXXXXXXXXXXXXXXXXXXXXXXXXXXXXXXXXX######XXXXXXXXXX.........
..XXXXXXXXXXXXXXXXXXXXXXXXXXXXXXXXXXXXXXXXXX#########XXXXXXXX.........
..XXXXXXXXXXXXXXXXXXXXXXXXXXXXXXXXXXXXXXXXXX##########AAXAXXX.........
..XXXXXXXXXXXXXXXXXXXXXXXXXXXXXXXXXXXXXXXXXXX###########AXXXX.........
...XXXXXXXXXXXXXXXXXXXXXXXXXXXXXXAXAXXXXXXXXXX##########XAXAA.........
..XXXXXXXXXXXXXXXXXXXXXXXXXXXX###XXXXXXXXXXXXXXAXXXA#####XXX..........
..XXXXXXXXXXXXXXXXXXXXXXXXXXX####AAXXXXXXXXXXXXXXXXXX###XXAX..........
..XXXXXXXXXXXXXXXXXXXXXXXXXX#####XXAXXXXXXXXXXXXXXXXXXAXXAAA..........
...XXXXAXXXXXXXXXXXXXXXXXXXA####AAXXXXXXXXXXXXXXXXXXXXXAXAA...........
...XXXXXXAAXXXXXXXXXXXXXXXX#####XAAXXXXXXXXXXXXXXXXXXXXAAXXX..........
...XXXXXAXXXXXXXXXXXXXXXXX#####AXAAXXXXXXXXXXXXXXXXXXXXXXXX...........
...XAAXXXXXXXXXXXXXXXXXXXX#####XXXXXXXXXXXXXXXXXXXXXXXXXXX............
...XXXXXXXXXXXXXXXXXXXXXXX####XXXXXXXXXXXXXXXXXXXXXXXXXXXX............
...AXXAXAXXXXXXXXXXXXXXXXXXXXXXXAXXXXXXXXXXXXXXXXXXXXXXXX.............
...XXAAXXXXXXXXXXXXXXXXXXAAXXAXXAXXXXXXXXXXXXXXXXXXXXXXXX.............
...XAXAXXXXXXXXXXXXXXXXXAXXXXAXXXXXXXXXXXXXXXXXXXXXXXXXXX.............
...XXXAXXXXXXXXXXXXXXXXXXAXXXXXXXXXXXXXXXXXXXXXXXXXXXXXX..............
...XAXXXXXXXXXXXXXXXXAXXXXXXXXXXXXXXXXXXXXXXXXXXXXXXXXXXX.............
...XXXAXXXXXXXXXXXXXXXAXXXXXXXXXXXXXXXXXXXXXXXXAXXXXXXX...............
....XAXXXXXXXXXXXXXXAXAXXXXXXXXXXXXXXXXXXXXXXXAXXXXXX.................
........XXXXXXXXXXXXXXXXXXXXXXXXXXXXXXXXXXXXXXAAAXXX..................
........XXXXXXXXXAAAAAAXXXXXXXXXXXXXXXXXXXXXXXX.......................
...........X.XXXXAXXXXAXXXXXXXXXXXXXXXXXXX.X..........................
.............XXXXXXAXAXXXXXXXXXXXXXXXX................................
......................................................................
......................................................................
......................................................................
.......X.XXXXAAXXAXXXXXXXXXXXXXXXAXAXAAXXXXXXXXXXXXX..................
..........X.XXXXXXXXXXXXXXXXXXAAXAXXXAXXAXXXXX........................
.............AXXAXXXXXXXXXXXXXXXXAXXXXXXAXX...........................
......................................................................
......................................................................
......................................................................
......................................................................

